008-016-016-018
################
###  ###########
###    o   o o #
### o# o #  o  #
###  o o  #    #
### o# #  #### #
#@#o o o  ##   #
#    o #o#   # #
#   o    o o o #
#####  #########
###      #######
###      #######
###......#######
###......#######
###......#######
################
