005-017-013-012
#################
#########   #####
######### #o##  #
#########     o #
######### ###   #
#....  ## o  o###
#....    o oo ###
#....  ##o  o @##
#########  o  ###
######### o o  ##
########### ## ##
###########    ##
#################

