009-017-014-014
#################
###########  ...#
###########  ...#
#######      . .#
#######  ##  ...#
######## ##  ...#
######## ########
###### ooo ######
######  o o #####
##   #o o   #   #
#@ o  o    o  o #
###### oo o #####
######      #####
#################
