006-012-011-010
############
#..  ####@##
#..  ###   #
#..     oo #
#..  # # o #
#..### # o #
#### o #o  #
####  o# o #
#### o  o  #
####  ##   #
############
