002-014-010-010
##############
#..  #     ###
#..  # o  o  #
#..  #o####  #
#..    @ ##  #
#..  # #  o ##
###### ##o o #
### o  o o o #
###    #     #
##############

