004-019-014-020
###################
############  ....#
############  ....#
#    #  o o   ....#
# ooo#o  o #  ....#
#  o     o #  ....#
# oo #o o o########
#  o #     ########
## ################
#    #    #########
#     o   #########
#  oo#oo  @########
#    #    #########
###################
