003-017-010-011
#################
#########     @##
######### o#o ###
######### o  o###
##########o o ###
######### o # ###
#....  ## o  o  #
##...    o  o   #
#....  ##########
#################

