#####
#####
#  ##
#@o.#
# o #
# .##
#####
