007-013-012-011
#############
########   ##
## # @## oo #
#    o      #
#  o  ###   #
### #####o###
# o  ### ..##
# o o o ...##
#    ###...##
# oo # #...##
#  ### ######
#############
