001-019-011-006
###################
#####   ###########
#####o  ###########
#####  o###########
###  o o ##########
### # ## ##########
#   # ## #####  ..#
# o  o          ..#
##### ### #@##  ..#
#####     #########
###################
